##.,####
##....##
#.,.,###
.,@..###
%..,.X,.
%..,.%##
#.,.%###
##%%####
