#######################....#######################..
######################......######################..
....................................................
....................................................
....................................................
....................................................
....................................................
.....#####.....########....########.....#####.......
##########.....########....########.....##########..
######......................................######..
....................................................
....................................................
....................................................
....................................................
......####..............................####........
......####............######............####........
................##################..................
................#######....#######..................
................#######....#######................##
###............................................#####
##########..............................############
...#######.............####.............#######...##
.......................####.......................##
................##################................##
................##################................##
...................############...................##
...................############...................##
..................................................##
######......................................########
######......................................########
######......#########........#########......########
######......#########........#########......########
#######################....#########################
#######################....#########################
