......................................................................................................................................................
..............................######################..................................................................................................
............................###########################...............................................................................................
..........................######..................############........................................................................................
.........................#####.......................##########.......................................................................................
.......................####.................................####......................................................................................
..................########...................................#####....................................................................................
.................##########...############################...#######..................................................................................
.................#####################################################................................................................................
................#######################################.###############.......#####...................................................................
..............###########################################################...#######...................................................................
..............#######################################.########.....#######.#########.#................................................................
.............####################.....................................################.#.........................#....................................
..............###########...............................................################.......................###....................................
.............##############.............................................###############.........................#####.................................
.............#.############.............................................################........................#####.................................
..............##########.#..............................................#################.......................#####.#...............................
..............##########.#.............................................##################......................#####..#...............................
...............##########..............................................#################........................######.#..............................
...............########.................................................###############..........................#######.#............................
...............######...................................................###############..........................######...............................
...............#####......................................................#############...........................######.#............................
...............#####...........................#.#.........................############...........................######.#............................
................###....................######.#.###........................##########............................######...#...........................
................###..................###############.......................###..#####..........................############.#.........................
...............###.................#################...........................#..###.........................###########.............................
...............###...............########################..........................###.......................#############............................
...............##...............###########################........................###......................##############............................
..............###...............#############################.......................###....................###############............................
..............###.............#.##############################.#....................####..................#########...................................
..............##...............################################......................####................##########...................................
..............##..............##################################......................####..#...#.......###########...................................
..............##.............####################################......................####.#.#.##.#...###########....................................
..............##.............###################################........................########.##..############.....................................
..............##...........#####################################.........................#####################........................................
..............##..........######################################..........................###################.....................................#...
.............###..........######################################...........................##################...................................###.#.
.............###.........#######################.#################...........................###############..................................########
.............###.........################...#....################............................##############...................................#######.
..............##.........################.........#.##############............................############...................................########.
..............##.........################.............############..............................##########..................................#########.
..............##.........##############...............############..............................###########.................................#########.
..............###..........###########...................#########................................##########...............................##########.
..............###.........###########....................#..#######................................#####.####..............................#########..
...............###.......############..................##...######...................................#....###.............................##########.#
...............###...##################......................######........................................###............................############
................##..##################.......................#####..........................................##............................############
................######################.......................#####..........................................###..........................#############
................#######################........................####.........................................###...........................############
.................############...#######.........................##...........................................##..........................#############
.................###########....#..####.......................................#....#.#.......................###..........................#.##########
......................####.........#####......................................#.#########.....................##...........................###########
....................................####.....................................############.....................##...........................###########
.....................................####....................................#############....................##............................##########
.....................................####...................................##############....................###...........................##########
......................................####..................................################...................##...........................##########
.......................................####.................................###############....................##..........................###########
...............................#############..............................################.....................##..........................###########
...........................##################.............................################.#..............#######.........................############
.........................########........#####...........................###################.............########..........................###########
...............####....######.............####...........................##################.............#########.........................############
..............#######.#####...............######...........#...........####################.............#############...................#############.
..............##########....................####....###.####.........######################............###############................#####.#########.
.............##########.....................######..#########.#...#############..#####.##............##################............######..#########..
.............##########......................######.###########..##########..##.....................###################...........######...##########.
.............##########.......................###########################...........................###################..........###........#######...
.............##########.........................#######################..............................##################......######.........#.#.#.#...
.............#########..........................######################..............................####################....######...........#........
.............#########..........................##################..................................###########################.......................
.............###########..........................#############......................................#########################........................
.............###########.........................#############......................................#####################.............................
...............#####..###........................#############.....................................#..#################...............................
......................####.......................#############.........................................###############................................
.......................####......................#############..........................................#############.#...............................
........................###........................###########........................................#.##############................................
.........................##.........................###..######..........................................#############................................
.........................###........................#.#..#.###..............................................#########.................................
..........................##...........................#..##.................................................######..#................................
..........................##...................................................................................#..#...................................
..........................##..........................................................................................................................
..........................##..........................................................................................................................
..........................#######.....................................................................................................................
..........................#########........................................................................................................#..........
........................############..................................................................................................#...###.........
.....................###############............................##########################################.........................###########........
....................################............................##########################################.......................##############.......
....................################............................##########################################.................#####################......
....................##################..........................##########################################.........#############################......
....................##################..........................##########################################...################....###############......
....................##################......###########....###########################################################..........################......
....................##########################################################################################...................###############......
....................######################################################################################.......................###############......
....................####################............######################################################........................############........
.....................#################......................##############################################........................#############.......
....................#################.......................##############################################.........................###########........
......................###############........................#############################################........................###########.#.......
.......................###############.......................#############################################.......................##########...........
.......................#.####..#######.......................#############################################.......................######...#...........
..........................###...######..........................##########################################......................######................
................................######...............................................############...............................######................
................................#######..#...........................................##########................................######.................
................................##########.#........................................#########..................................#####..................
................................#############.......................................#######...................................######..................
................................############..................................#....#######...................................#######..................
...............................#############.................................###########.....................................######...................
...............................##############................................###########.....................................#####....................
..............................##############................................###########.....................................######....................
..............................##############..............................##############....................................#####.....................
..............................#############.#...........................#################...................................#####.....................
............................#################..........................###################.............................#..######......................
...........................###############.#..........................####################.............................#########......................
..........................################.#..........................####################............................#########.......................
.........................################.............................###################.............................#########.......................
..................###.####################............................###################............................##########.......................
..................##############......##..............................###################............................##########.......................
..................############.........................................##################............................############.....................
................##############.........................................##################..........................###########.#......................
...............################........................................#################...........................############.......................
..............#################........................................##################.........................#############.#.....................
..............#################.......................................#####################........................##############.....................
................###############......................................#######...#.##..#.######.....................############.#......................
...............################....................................########..............#####.....................########.#..#......................
...............################..................................#########.................####....................#####.##.#.........................
...............################.................................#########...................####...................##.##..............................
...............################...............................#########.......................###.................###.................................
.................################...........................###########.......................####...............###..................................
..................###..###########.........................###########...............######....####..............###..................................
..................#.#..#.##########........................#########................#######......###.............###..................................
.....................#..##..########......................########..................#######.......###.####......###...................................
.............................##########.......####.......########...................#######.......########......###...................................
...............................###########...#####....#.#######.....................######.........########.....####..................................
................................############.######..########.......................................#######....#####..................................
..................................############################....................................###########..#####..................................
....................................##########################....................................##########..######..................................
....................................##########################...................................###########..#######.................................
....................................##########################...................................############..#########..............................
....................................##########################...................................############..##########.............................
...................................###########################..................................############...##########.............................
....................................##########################...................................###########...##########.............................
....................................#########################....................................#########.....##########.............................
.....................................#######################......................................#########......########.............................
.....................................####################☺####....................................#.######.......#######..............................
.....................................#########################.....................................##.#.#.#...........................................
.......................................####################.#........................................#................................................
..........................................###################.........................................................................................
...........................................##..##.....####............................................................................................
......................................................................................................................................................
......................................................................................................................................................
......................................................................................................................................................
......................................................................................................................................................
